{
  "name": "Geonix rev.2",
  "vendorProductId": 917516386,
  "macros": ["->", "", "", "", "", "", "", "", "", "", "", "", "", "", "", ""],
  "layers": [
    [
      "KC_TAB",
      "KC_Q",
      "KC_W",
      "KC_E",
      "KC_R",
      "KC_T",
      "KC_Y",
      "KC_U",
      "KC_I",
      "KC_O",
      "KC_P",
      "KC_BSPC",
      "KC_NO",
      "KC_NO",
      "KC_NO",
      "KC_NO",
      "KC_ESC",
      "MT(MOD_LCTL,KC_A)",
      "MT(MOD_LALT,KC_S)",
      "MT(MOD_LGUI,KC_D)",
      "MT(MOD_LSFT,KC_F)",
      "KC_G",
      "KC_H",
      "MT(MOD_LSFT | MOD_RSFT,KC_J)",
      "MT(MOD_LGUI | MOD_RGUI,KC_K)",
      "MT(MOD_LALT | MOD_RALT,KC_L)",
      "MT(MOD_LCTL | MOD_RCTL,KC_SCLN)",
      "KC_ENT",
      "KC_NO",
      "KC_NO",
      "KC_NO",
      "KC_NO",
      "MT(MOD_LSFT,KC_MINS)",
      "KC_Z",
      "KC_X",
      "KC_C",
      "KC_V",
      "KC_B",
      "KC_N",
      "KC_M",
      "KC_COMM",
      "KC_DOT",
      "KC_SLSH",
      "MT(MOD_LSFT | MOD_RSFT,KC_QUOT)",
      "KC_NO",
      "KC_NO",
      "KC_NO",
      "KC_NO",
      "MO(3)",
      "KC_LCTL",
      "KC_LALT",
      "KC_LGUI",
      "MO(1)",
      "KC_NO",
      "KC_SPC",
      "MO(2)",
      "KC_LEFT",
      "KC_DOWN",
      "KC_UP",
      "KC_RGHT",
      "KC_NO",
      "KC_NO",
      "KC_NO",
      "KC_NO",
      "KC_NO",
      "KC_NO",
      "KC_NO",
      "KC_NO",
      "KC_NO",
      "KC_NO",
      "KC_NO",
      "KC_NO",
      "KC_NO",
      "KC_NO",
      "KC_NO",
      "KC_NO",
      "KC_NO",
      "KC_NO",
      "KC_NO",
      "KC_NO",
      "KC_NO",
      "KC_NO",
      "KC_NO",
      "KC_NO",
      "KC_NO",
      "KC_NO",
      "KC_NO",
      "KC_NO",
      "KC_NO",
      "KC_NO",
      "KC_NO",
      "KC_NO",
      "KC_NO",
      "KC_NO",
      "KC_NO",
      "KC_NO"
    ],
    [
      "S(KC_GRV)",
      "S(KC_1)",
      "S(KC_2)",
      "S(KC_3)",
      "S(KC_4)",
      "S(KC_5)",
      "S(KC_6)",
      "S(KC_7)",
      "S(KC_8)",
      "S(KC_9)",
      "S(KC_0)",
      "KC_DEL",
      "KC_NO",
      "KC_NO",
      "KC_NO",
      "KC_NO",
      "KC_ESC",
      "KC_NO",
      "KC_NO",
      "KC_NO",
      "KC_NO",
      "S(KC_9)",
      "S(KC_0)",
      "S(KC_MINS)",
      "S(KC_EQL)",
      "S(KC_LBRC)",
      "S(KC_RBRC)",
      "KC_NO",
      "KC_NO",
      "KC_NO",
      "KC_NO",
      "KC_NO",
      "KC_LSFT",
      "KC_NO",
      "KC_NO",
      "KC_NO",
      "KC_NO",
      "KC_LBRC",
      "KC_RBRC",
      "KC_EQL",
      "S(KC_COMM)",
      "S(KC_DOT)",
      "KC_BSLS",
      "KC_RSFT",
      "KC_NO",
      "KC_NO",
      "KC_NO",
      "KC_NO",
      "KC_NO",
      "KC_NO",
      "KC_NO",
      "KC_NO",
      "KC_NO",
      "KC_NO",
      "MACRO(0)",
      "KC_NO",
      "KC_HOME",
      "KC_PGDN",
      "KC_PGUP",
      "KC_END",
      "KC_NO",
      "KC_NO",
      "KC_NO",
      "KC_NO",
      "KC_NO",
      "KC_NO",
      "KC_NO",
      "KC_NO",
      "KC_NO",
      "KC_NO",
      "KC_NO",
      "KC_NO",
      "KC_NO",
      "KC_NO",
      "KC_NO",
      "KC_NO",
      "KC_NO",
      "KC_NO",
      "KC_NO",
      "KC_NO",
      "KC_NO",
      "KC_NO",
      "KC_NO",
      "KC_NO",
      "KC_NO",
      "KC_NO",
      "KC_NO",
      "KC_NO",
      "KC_NO",
      "KC_NO",
      "KC_NO",
      "KC_NO",
      "KC_NO",
      "KC_NO",
      "KC_NO",
      "KC_NO"
    ],
    [
      "KC_GRV",
      "KC_1",
      "KC_2",
      "KC_3",
      "KC_4",
      "KC_5",
      "KC_6",
      "KC_7",
      "KC_8",
      "KC_9",
      "KC_0",
      "KC_DEL",
      "KC_NO",
      "KC_NO",
      "KC_NO",
      "KC_NO",
      "KC_ESC",
      "KC_F1",
      "KC_F2",
      "KC_F3",
      "KC_F4",
      "KC_F5",
      "KC_F6",
      "KC_DOWN",
      "KC_UP",
      "KC_LBRC",
      "KC_RBRC",
      "KC_PGUP",
      "KC_NO",
      "KC_NO",
      "KC_NO",
      "KC_NO",
      "KC_LSFT",
      "KC_F7",
      "KC_F8",
      "KC_F9",
      "KC_F10",
      "KC_F11",
      "KC_F12",
      "KC_NO",
      "KC_HOME",
      "KC_END",
      "S(KC_BSLS)",
      "KC_PGDN",
      "KC_NO",
      "KC_NO",
      "KC_NO",
      "KC_NO",
      "KC_NO",
      "KC_NO",
      "KC_NO",
      "KC_NO",
      "KC_NO",
      "KC_NO",
      "S(KC_MINS)",
      "KC_NO",
      "KC_MUTE",
      "KC_VOLD",
      "KC_VOLU",
      "KC_MPLY",
      "KC_NO",
      "KC_NO",
      "KC_NO",
      "KC_NO",
      "KC_NO",
      "KC_NO",
      "KC_NO",
      "KC_NO",
      "KC_NO",
      "KC_NO",
      "KC_NO",
      "KC_NO",
      "KC_NO",
      "KC_NO",
      "KC_NO",
      "KC_NO",
      "KC_NO",
      "KC_NO",
      "KC_NO",
      "KC_NO",
      "KC_NO",
      "KC_NO",
      "KC_NO",
      "KC_NO",
      "KC_NO",
      "KC_NO",
      "KC_NO",
      "KC_NO",
      "KC_NO",
      "KC_NO",
      "KC_NO",
      "KC_NO",
      "KC_NO",
      "KC_NO",
      "KC_NO",
      "KC_NO"
    ],
    [
      "CUSTOM(4)",
      "CUSTOM(1)",
      "CUSTOM(2)",
      "CUSTOM(3)",
      "CUSTOM(0)",
      "RGB_MOD",
      "KC_NO",
      "KC_NO",
      "KC_NO",
      "KC_NO",
      "KC_NO",
      "CUSTOM(8)",
      "KC_NO",
      "KC_NO",
      "KC_NO",
      "KC_NO",
      "KC_NO",
      "KC_NO",
      "KC_NO",
      "KC_NO",
      "KC_NO",
      "KC_NO",
      "KC_NO",
      "KC_NO",
      "KC_NO",
      "KC_NO",
      "KC_NO",
      "KC_NO",
      "KC_NO",
      "KC_NO",
      "KC_NO",
      "KC_NO",
      "KC_NO",
      "KC_NO",
      "KC_NO",
      "KC_NO",
      "KC_NO",
      "KC_NO",
      "KC_NO",
      "KC_NO",
      "KC_NO",
      "KC_NO",
      "RGB_VAI",
      "CUSTOM(5)",
      "KC_NO",
      "KC_NO",
      "KC_NO",
      "KC_NO",
      "KC_NO",
      "HYPR(KC_NO)",
      "KC_NO",
      "KC_NO",
      "KC_NO",
      "KC_NO",
      "CUSTOM(9)",
      "KC_NO",
      "KC_NO",
      "RGB_SPD",
      "RGB_VAD",
      "RGB_SPI",
      "KC_NO",
      "KC_NO",
      "KC_NO",
      "KC_NO",
      "KC_NO",
      "KC_NO",
      "KC_NO",
      "KC_NO",
      "KC_NO",
      "KC_NO",
      "KC_NO",
      "KC_NO",
      "KC_NO",
      "KC_NO",
      "KC_NO",
      "KC_NO",
      "KC_NO",
      "KC_NO",
      "KC_NO",
      "KC_NO",
      "KC_NO",
      "KC_NO",
      "KC_NO",
      "KC_NO",
      "KC_NO",
      "KC_NO",
      "KC_NO",
      "KC_NO",
      "KC_NO",
      "KC_NO",
      "KC_NO",
      "KC_NO",
      "KC_NO",
      "KC_NO",
      "KC_NO",
      "KC_NO"
    ]
  ],
  "encoders": []
}